1111111111111
1X01C000000C1
1000011111001
1P0011E000001
1111111111111