1111111111111111111111111111111111
1E0000000000000C00000C000000000001
101001X100100000101X01000000010101
1010010010101010001001000000010101
1P0000000C00C0000000000000000000C1
1000000000000000001111100100C00001
1000000000000000000000000000011001
1111100000000000000000000000000111
1000111000000000000000000000001101
1C001111000110X0000000111111100X01
1010011100000000101X01000000010101
101111110000000000000C000110001001
1000111000000000000000000000001101
100000000C00C0000000000000000000C1
1000000000000000000000000000011001
1000C000000000000000000000000000C1
1111111111111111111111111111111111