1111111111111
1X01000000001
1100011111001
1P0011E0000C1
1111111111111