1111111111111
1X01000000001
1100011111001
1P0011E000C01
1111111111111
