1111111111111
1X01000000001
1100011111001
1P00110E000M1
1111111111111