1111111111111111111111111111111111
1E0000000000000C00000C000000000001
101001X100100000101X010c0000010101
101001001010101000100100M000010101
1P0c00000C00C000000000000000000cC1
1111111111111111111111111111111111
