1111111111111
1X01C000000M1
1000011111001
1P0011E0000c1
1111111111111